Keyword,City,Date,All,PC,Mobile
台风,上海,2024/8/21,2882,957,1925
台风,上海,2024/8/22,1968,849,1119
台风,上海,2024/8/23,1687,698,989
台风,上海,2024/8/24,1137,229,908
台风,上海,2024/8/25,1282,282,1000
台风,上海,2024/8/26,2295,896,1399
台风,上海,2024/8/27,3187,1056,2131
台风,上海,2024/8/28,2920,995,1925
台风,上海,2024/8/29,2612,959,1653
台风,上海,2024/8/30,2007,883,1124
台风,上海,2024/8/31,1290,321,969
台风,上海,2024/9/1,1694,392,1302
台风,上海,2024/9/2,2920,1021,1899
台风,上海,2024/9/3,3352,1201,2151
台风,上海,2024/9/4,3698,1315,2383
台风,上海,2024/9/5,8720,3727,4993
台风,上海,2024/9/6,25127,6498,18629
台风,上海,2024/9/7,7665,1372,6293
台风,上海,2024/9/8,4457,923,3534
台风,上海,2024/9/9,4179,1594,2585
台风,上海,2024/9/10,13805,3803,10002
台风,上海,2024/9/11,19319,5897,13422
台风,上海,2024/9/12,20477,6368,14109
台风,上海,2024/9/13,32502,10160,22342
台风,上海,2024/9/14,69338,19072,50266
台风,上海,2024/9/15,151177,18052,133125
台风,上海,2024/9/16,162567,18153,144414
台风,上海,2024/9/17,27413,3180,24233
台风,上海,2024/9/18,67081,21026,46055
台风,上海,2024/9/19,133808,37367,96441
台风,上海,2024/9/20,62280,14884,47396
台风,丽水,2024/8/21,397,112,285
台风,丽水,2024/8/22,224,83,141
台风,丽水,2024/8/23,250,85,165
台风,丽水,2024/8/24,180,61,119
台风,丽水,2024/8/25,207,63,144
台风,丽水,2024/8/26,231,93,138
台风,丽水,2024/8/27,307,93,214
台风,丽水,2024/8/28,375,120,255
台风,丽水,2024/8/29,264,102,162
台风,丽水,2024/8/30,212,91,121
台风,丽水,2024/8/31,223,68,155
台风,丽水,2024/9/1,246,72,174
台风,丽水,2024/9/2,353,125,228
台风,丽水,2024/9/3,325,110,215
台风,丽水,2024/9/4,344,123,221
台风,丽水,2024/9/5,590,179,411
台风,丽水,2024/9/6,1239,299,940
台风,丽水,2024/9/7,633,140,493
台风,丽水,2024/9/8,463,101,362
台风,丽水,2024/9/9,310,102,208
台风,丽水,2024/9/10,631,142,489
台风,丽水,2024/9/11,973,239,734
台风,丽水,2024/9/12,1182,321,861
台风,丽水,2024/9/13,1353,425,928
台风,丽水,2024/9/14,1861,645,1216
台风,丽水,2024/9/15,1977,330,1647
台风,丽水,2024/9/16,1664,245,1419
台风,丽水,2024/9/17,969,127,842
台风,丽水,2024/9/18,1526,554,972
台风,丽水,2024/9/19,2318,817,1501
台风,丽水,2024/9/20,1058,276,782
台风,亳州,2024/8/21,58,0,58
台风,亳州,2024/8/22,67,0,67
台风,亳州,2024/8/23,122,59,63
台风,亳州,2024/8/24,65,0,65
台风,亳州,2024/8/25,122,57,65
台风,亳州,2024/8/26,120,57,63
台风,亳州,2024/8/27,126,57,69
台风,亳州,2024/8/28,127,57,70
台风,亳州,2024/8/29,115,57,58
台风,亳州,2024/8/30,66,0,66
台风,亳州,2024/8/31,115,57,58
台风,亳州,2024/9/1,120,57,63
台风,亳州,2024/9/2,65,0,65
台风,亳州,2024/9/3,65,0,65
台风,亳州,2024/9/4,176,57,119
台风,亳州,2024/9/5,207,68,139
台风,亳州,2024/9/6,349,97,252
台风,亳州,2024/9/7,284,78,206
台风,亳州,2024/9/8,236,66,170
台风,亳州,2024/9/9,184,63,121
台风,亳州,2024/9/10,149,57,92
台风,亳州,2024/9/11,92,0,92
台风,亳州,2024/9/12,176,66,110
台风,亳州,2024/9/13,189,68,121
台风,亳州,2024/9/14,248,66,182
台风,亳州,2024/9/15,415,78,337
台风,亳州,2024/9/16,837,89,748
台风,亳州,2024/9/17,978,95,883
台风,亳州,2024/9/18,506,104,402
台风,亳州,2024/9/19,428,93,335
台风,亳州,2024/9/20,310,78,232
台风,六安,2024/8/21,130,57,73
台风,六安,2024/8/22,137,59,78
台风,六安,2024/8/23,119,61,58
台风,六安,2024/8/24,126,57,69
台风,六安,2024/8/25,82,0,82
台风,六安,2024/8/26,70,0,70
台风,六安,2024/8/27,137,59,78
台风,六安,2024/8/28,147,63,84
台风,六安,2024/8/29,134,63,71
台风,六安,2024/8/30,133,59,74
台风,六安,2024/8/31,123,57,66
台风,六安,2024/9/1,82,0,82
台风,六安,2024/9/2,148,57,91
台风,六安,2024/9/3,150,63,87
台风,六安,2024/9/4,176,63,113
台风,六安,2024/9/5,267,91,176
台风,六安,2024/9/6,553,155,398
台风,六安,2024/9/7,368,102,266
台风,六安,2024/9/8,237,66,171
台风,六安,2024/9/9,191,72,119
台风,六安,2024/9/10,215,64,151
台风,六安,2024/9/11,256,101,155
台风,六安,2024/9/12,255,82,173
台风,六安,2024/9/13,261,102,159
台风,六安,2024/9/14,432,125,307
台风,六安,2024/9/15,881,154,727
台风,六安,2024/9/16,1342,231,1111
台风,六安,2024/9/17,1060,144,916
台风,六安,2024/9/18,595,161,434
台风,六安,2024/9/19,663,163,500
台风,六安,2024/9/20,477,139,338
台风,南京,2024/8/21,466,168,298
台风,南京,2024/8/22,344,139,205
台风,南京,2024/8/23,303,114,189
台风,南京,2024/8/24,258,72,186
台风,南京,2024/8/25,241,80,161
台风,南京,2024/8/26,410,182,228
台风,南京,2024/8/27,546,180,366
台风,南京,2024/8/28,515,170,345
台风,南京,2024/8/29,429,159,270
台风,南京,2024/8/30,356,152,204
台风,南京,2024/8/31,268,83,185
台风,南京,2024/9/1,293,76,217
台风,南京,2024/9/2,607,212,395
台风,南京,2024/9/3,706,251,455
台风,南京,2024/9/4,1039,309,730
台风,南京,2024/9/5,1798,845,953
台风,南京,2024/9/6,6766,1049,5717
台风,南京,2024/9/7,1869,498,1371
台风,南京,2024/9/8,1170,260,910
台风,南京,2024/9/9,1088,408,680
台风,南京,2024/9/10,1352,448,904
台风,南京,2024/9/11,2419,855,1564
台风,南京,2024/9/12,2155,794,1361
台风,南京,2024/9/13,2650,935,1715
台风,南京,2024/9/14,6155,1681,4474
台风,南京,2024/9/15,14438,1500,12938
台风,南京,2024/9/16,35010,4591,30419
台风,南京,2024/9/17,9261,972,8289
台风,南京,2024/9/18,8569,2599,5970
台风,南京,2024/9/19,15812,4450,11362
台风,南京,2024/9/20,12372,3406,8966
台风,南通,2024/8/21,515,177,338
台风,南通,2024/8/22,284,91,193
台风,南通,2024/8/23,272,99,173
台风,南通,2024/8/24,238,68,170
台风,南通,2024/8/25,281,83,198
台风,南通,2024/8/26,334,114,220
台风,南通,2024/8/27,409,108,301
台风,南通,2024/8/28,425,129,296
台风,南通,2024/8/29,382,137,245
台风,南通,2024/8/30,318,118,200
台风,南通,2024/8/31,267,85,182
台风,南通,2024/9/1,288,68,220
台风,南通,2024/9/2,442,162,280
台风,南通,2024/9/3,448,173,275
台风,南通,2024/9/4,548,175,373
台风,南通,2024/9/5,1020,360,660
台风,南通,2024/9/6,2637,592,2045
台风,南通,2024/9/7,1201,298,903
台风,南通,2024/9/8,846,170,676
台风,南通,2024/9/9,648,183,465
台风,南通,2024/9/10,1080,237,843
台风,南通,2024/9/11,1395,406,989
台风,南通,2024/9/12,1372,403,969
台风,南通,2024/9/13,1845,588,1257
台风,南通,2024/9/14,3953,914,3039
台风,南通,2024/9/15,10586,1125,9461
台风,南通,2024/9/16,13735,1222,12513
台风,南通,2024/9/17,2658,381,2277
台风,南通,2024/9/18,3401,906,2495
台风,南通,2024/9/19,6385,1288,5097
台风,南通,2024/9/20,5468,1109,4359
台风,台州,2024/8/21,3510,692,2818
台风,台州,2024/8/22,1311,336,975
台风,台州,2024/8/23,1169,231,938
台风,台州,2024/8/24,972,127,845
台风,台州,2024/8/25,995,121,874
台风,台州,2024/8/26,1100,218,882
台风,台州,2024/8/27,2298,433,1865
台风,台州,2024/8/28,2078,454,1624
台风,台州,2024/8/29,1358,349,1009
台风,台州,2024/8/30,1112,240,872
台风,台州,2024/8/31,1119,182,937
台风,台州,2024/9/1,1650,186,1464
台风,台州,2024/9/2,2393,563,1830
台风,台州,2024/9/3,1713,383,1330
台风,台州,2024/9/4,1807,372,1435
台风,台州,2024/9/5,3162,887,2275
台风,台州,2024/9/6,6932,1221,5711
台风,台州,2024/9/7,3855,833,3022
台风,台州,2024/9/8,1994,313,1681
台风,台州,2024/9/9,1540,440,1100
台风,台州,2024/9/10,8161,1153,7008
台风,台州,2024/9/11,9625,1558,8067
台风,台州,2024/9/12,13198,2195,11003
台风,台州,2024/9/13,15156,2508,12648
台风,台州,2024/9/14,24347,3902,20445
台风,台州,2024/9/15,26619,2438,24181
台风,台州,2024/9/16,17119,1411,15708
台风,台州,2024/9/17,8892,844,8048
台风,台州,2024/9/18,23938,3869,20069
台风,台州,2024/9/19,36067,5807,30260
台风,台州,2024/9/20,6225,1018,5207
台风,合肥,2024/8/21,227,93,134
台风,合肥,2024/8/22,189,76,113
台风,合肥,2024/8/23,158,66,92
台风,合肥,2024/8/24,156,61,95
台风,合肥,2024/8/25,146,57,89
台风,合肥,2024/8/26,201,80,121
台风,合肥,2024/8/27,299,99,200
台风,合肥,2024/8/28,249,78,171
台风,合肥,2024/8/29,253,102,151
台风,合肥,2024/8/30,208,87,121
台风,合肥,2024/8/31,162,63,99
台风,合肥,2024/9/1,193,76,117
台风,合肥,2024/9/2,293,104,189
台风,合肥,2024/9/3,311,129,182
台风,合肥,2024/9/4,464,173,291
台风,合肥,2024/9/5,1063,431,632
台风,合肥,2024/9/6,1915,766,1149
台风,合肥,2024/9/7,1218,310,908
台风,合肥,2024/9/8,756,165,591
台风,合肥,2024/9/9,535,225,310
台风,合肥,2024/9/10,559,190,369
台风,合肥,2024/9/11,931,318,613
台风,合肥,2024/9/12,857,264,593
台风,合肥,2024/9/13,938,310,628
台风,合肥,2024/9/14,1468,521,947
台风,合肥,2024/9/15,2908,506,2402
台风,合肥,2024/9/16,6294,869,5425
台风,合肥,2024/9/17,3709,461,3248
台风,合肥,2024/9/18,2351,865,1486
台风,合肥,2024/9/19,2653,882,1771
台风,合肥,2024/9/20,2072,744,1328
台风,嘉兴,2024/8/21,896,226,670
台风,嘉兴,2024/8/22,529,159,370
台风,嘉兴,2024/8/23,452,140,312
台风,嘉兴,2024/8/24,362,99,263
台风,嘉兴,2024/8/25,442,95,347
台风,嘉兴,2024/8/26,533,168,365
台风,嘉兴,2024/8/27,979,223,756
台风,嘉兴,2024/8/28,1112,276,836
台风,嘉兴,2024/8/29,684,215,469
台风,嘉兴,2024/8/30,470,146,324
台风,嘉兴,2024/8/31,440,110,330
台风,嘉兴,2024/9/1,831,139,692
台风,嘉兴,2024/9/2,1112,349,763
台风,嘉兴,2024/9/3,860,225,635
台风,嘉兴,2024/9/4,995,260,735
台风,嘉兴,2024/9/5,1601,675,926
台风,嘉兴,2024/9/6,3523,918,2605
台风,嘉兴,2024/9/7,1674,506,1168
台风,嘉兴,2024/9/8,1071,193,878
台风,嘉兴,2024/9/9,1022,291,731
台风,嘉兴,2024/9/10,2689,834,1855
台风,嘉兴,2024/9/11,3733,1025,2708
台风,嘉兴,2024/9/12,3571,990,2581
台风,嘉兴,2024/9/13,6034,1621,4413
台风,嘉兴,2024/9/14,13481,3346,10135
台风,嘉兴,2024/9/15,28994,3649,25345
台风,嘉兴,2024/9/16,26751,2797,23954
台风,嘉兴,2024/9/17,4581,718,3863
台风,嘉兴,2024/9/18,8973,2379,6594
台风,嘉兴,2024/9/19,21180,4855,16325
台风,嘉兴,2024/9/20,6691,1280,5411
台风,宁波,2024/8/21,3503,866,2637
台风,宁波,2024/8/22,1841,537,1304
台风,宁波,2024/8/23,1416,400,1016
台风,宁波,2024/8/24,1099,182,917
台风,宁波,2024/8/25,1352,188,1164
台风,宁波,2024/8/26,1699,509,1190
台风,宁波,2024/8/27,3481,796,2685
台风,宁波,2024/8/28,3220,865,2355
台风,宁波,2024/8/29,2568,779,1789
台风,宁波,2024/8/30,1273,326,947
台风,宁波,2024/8/31,1414,216,1198
台风,宁波,2024/9/1,2127,254,1873
台风,宁波,2024/9/2,3224,898,2326
台风,宁波,2024/9/3,2974,859,2115
台风,宁波,2024/9/4,2748,789,1959
台风,宁波,2024/9/5,4333,1271,3062
台风,宁波,2024/9/6,9899,2076,7823
台风,宁波,2024/9/7,4461,873,3588
台风,宁波,2024/9/8,2853,457,2396
台风,宁波,2024/9/9,2703,872,1831
台风,宁波,2024/9/10,10562,2152,8410
台风,宁波,2024/9/11,13838,3264,10574
台风,宁波,2024/9/12,17687,3923,13764
台风,宁波,2024/9/13,27885,6207,21678
台风,宁波,2024/9/14,46325,9842,36483
台风,宁波,2024/9/15,77018,8087,68931
台风,宁波,2024/9/16,48124,3681,44443
台风,宁波,2024/9/17,14246,1093,13153
台风,宁波,2024/9/18,39047,8520,30527
台风,宁波,2024/9/19,72793,16349,56444
台风,宁波,2024/9/20,13695,2801,10894
台风,安庆,2024/8/21,138,64,74
台风,安庆,2024/8/22,128,59,69
台风,安庆,2024/8/23,115,57,58
台风,安庆,2024/8/24,123,57,66
台风,安庆,2024/8/25,126,57,69
台风,安庆,2024/8/26,129,59,70
台风,安庆,2024/8/27,84,0,84
台风,安庆,2024/8/28,126,59,67
台风,安庆,2024/8/29,127,61,66
台风,安庆,2024/8/30,126,59,67
台风,安庆,2024/8/31,122,59,63
台风,安庆,2024/9/1,130,59,71
台风,安庆,2024/9/2,154,61,93
台风,安庆,2024/9/3,170,64,106
台风,安庆,2024/9/4,160,61,99
台风,安庆,2024/9/5,279,89,190
台风,安庆,2024/9/6,463,114,349
台风,安庆,2024/9/7,322,91,231
台风,安庆,2024/9/8,256,78,178
台风,安庆,2024/9/9,191,68,123
台风,安庆,2024/9/10,205,82,123
台风,安庆,2024/9/11,246,87,159
台风,安庆,2024/9/12,209,74,135
台风,安庆,2024/9/13,251,93,158
台风,安庆,2024/9/14,350,116,234
台风,安庆,2024/9/15,737,110,627
台风,安庆,2024/9/16,1079,165,914
台风,安庆,2024/9/17,696,91,605
台风,安庆,2024/9/18,466,120,346
台风,安庆,2024/9/19,530,154,376
台风,安庆,2024/9/20,381,131,250
台风,宣城,2024/8/21,168,82,86
台风,宣城,2024/8/22,121,61,60
台风,宣城,2024/8/23,126,59,67
台风,宣城,2024/8/24,76,0,76
台风,宣城,2024/8/25,131,57,74
台风,宣城,2024/8/26,128,57,71
台风,宣城,2024/8/27,162,70,92
台风,宣城,2024/8/28,160,63,97
台风,宣城,2024/8/29,142,59,83
台风,宣城,2024/8/30,135,59,76
台风,宣城,2024/8/31,146,57,89
台风,宣城,2024/9/1,141,59,82
台风,宣城,2024/9/2,161,59,102
台风,宣城,2024/9/3,176,68,108
台风,宣城,2024/9/4,184,72,112
台风,宣城,2024/9/5,276,121,155
台风,宣城,2024/9/6,488,169,319
台风,宣城,2024/9/7,360,110,250
台风,宣城,2024/9/8,244,63,181
台风,宣城,2024/9/9,200,68,132
台风,宣城,2024/9/10,246,82,164
台风,宣城,2024/9/11,310,93,217
台风,宣城,2024/9/12,311,106,205
台风,宣城,2024/9/13,377,106,271
台风,宣城,2024/9/14,694,175,519
台风,宣城,2024/9/15,1144,172,972
台风,宣城,2024/9/16,1804,296,1508
台风,宣城,2024/9/17,842,101,741
台风,宣城,2024/9/18,695,183,512
台风,宣城,2024/9/19,1040,228,812
台风,宣城,2024/9/20,734,170,564
台风,宿州,2024/8/21,79,0,79
台风,宿州,2024/8/22,65,0,65
台风,宿州,2024/8/23,71,0,71
台风,宿州,2024/8/24,65,0,65
台风,宿州,2024/8/25,131,57,74
台风,宿州,2024/8/26,130,57,73
台风,宿州,2024/8/27,139,59,80
台风,宿州,2024/8/28,135,57,78
台风,宿州,2024/8/29,127,57,70
台风,宿州,2024/8/30,69,0,69
台风,宿州,2024/8/31,65,0,65
台风,宿州,2024/9/1,69,0,69
台风,宿州,2024/9/2,79,0,79
台风,宿州,2024/9/3,137,59,78
台风,宿州,2024/9/4,165,59,106
台风,宿州,2024/9/5,225,70,155
台风,宿州,2024/9/6,416,99,317
台风,宿州,2024/9/7,316,78,238
台风,宿州,2024/9/8,272,83,189
台风,宿州,2024/9/9,122,0,122
台风,宿州,2024/9/10,115,0,115
台风,宿州,2024/9/11,218,66,152
台风,宿州,2024/9/12,206,57,149
台风,宿州,2024/9/13,208,70,138
台风,宿州,2024/9/14,360,82,278
台风,宿州,2024/9/15,692,76,616
台风,宿州,2024/9/16,1027,118,909
台风,宿州,2024/9/17,1052,106,946
台风,宿州,2024/9/18,1006,150,856
台风,宿州,2024/9/19,919,157,762
台风,宿州,2024/9/20,769,148,621
台风,宿迁,2024/8/21,126,57,69
台风,宿迁,2024/8/22,124,59,65
台风,宿迁,2024/8/23,115,57,58
台风,宿迁,2024/8/24,137,57,80
台风,宿迁,2024/8/25,71,0,71
台风,宿迁,2024/8/26,138,64,74
台风,宿迁,2024/8/27,128,61,67
台风,宿迁,2024/8/28,135,59,76
台风,宿迁,2024/8/29,122,57,65
台风,宿迁,2024/8/30,67,0,67
台风,宿迁,2024/8/31,118,57,61
台风,宿迁,2024/9/1,65,0,65
台风,宿迁,2024/9/2,152,72,80
台风,宿迁,2024/9/3,145,59,86
台风,宿迁,2024/9/4,172,66,106
台风,宿迁,2024/9/5,284,121,163
台风,宿迁,2024/9/6,1123,186,937
台风,宿迁,2024/9/7,370,116,254
台风,宿迁,2024/9/8,308,72,236
台风,宿迁,2024/9/9,232,85,147
台风,宿迁,2024/9/10,202,68,134
台风,宿迁,2024/9/11,303,97,206
台风,宿迁,2024/9/12,320,120,200
台风,宿迁,2024/9/13,316,108,208
台风,宿迁,2024/9/14,554,155,399
台风,宿迁,2024/9/15,1018,157,861
台风,宿迁,2024/9/16,1392,245,1147
台风,宿迁,2024/9/17,1064,148,916
台风,宿迁,2024/9/18,721,168,553
台风,宿迁,2024/9/19,1005,237,768
台风,宿迁,2024/9/20,917,215,702
台风,常州,2024/8/21,312,120,192
台风,常州,2024/8/22,212,76,136
台风,常州,2024/8/23,229,72,157
台风,常州,2024/8/24,231,64,167
台风,常州,2024/8/25,210,59,151
台风,常州,2024/8/26,247,80,167
台风,常州,2024/8/27,307,95,212
台风,常州,2024/8/28,336,116,220
台风,常州,2024/8/29,278,108,170
台风,常州,2024/8/30,242,80,162
台风,常州,2024/8/31,204,68,136
台风,常州,2024/9/1,228,70,158
台风,常州,2024/9/2,414,125,289
台风,常州,2024/9/3,397,135,262
台风,常州,2024/9/4,436,137,299
台风,常州,2024/9/5,879,333,546
台风,常州,2024/9/6,2448,605,1843
台风,常州,2024/9/7,1115,264,851
台风,常州,2024/9/8,727,142,585
台风,常州,2024/9/9,577,215,362
台风,常州,2024/9/10,758,198,560
台风,常州,2024/9/11,1349,437,912
台风,常州,2024/9/12,1270,405,865
台风,常州,2024/9/13,1448,530,918
台风,常州,2024/9/14,2949,915,2034
台风,常州,2024/9/15,8011,991,7020
台风,常州,2024/9/16,19837,2377,17460
台风,常州,2024/9/17,4468,662,3806
台风,常州,2024/9/18,4874,1344,3530
台风,常州,2024/9/19,10406,2510,7896
台风,常州,2024/9/20,9300,1994,7306
台风,徐州,2024/8/21,178,57,121
台风,徐州,2024/8/22,147,61,86
台风,徐州,2024/8/23,159,57,102
台风,徐州,2024/8/24,145,61,84
台风,徐州,2024/8/25,161,57,104
台风,徐州,2024/8/26,187,70,117
台风,徐州,2024/8/27,205,64,141
台风,徐州,2024/8/28,173,61,112
台风,徐州,2024/8/29,169,64,105
台风,徐州,2024/8/30,154,57,97
台风,徐州,2024/8/31,137,57,80
台风,徐州,2024/9/1,150,63,87
台风,徐州,2024/9/2,159,66,93
台风,徐州,2024/9/3,191,82,109
台风,徐州,2024/9/4,244,70,174
台风,徐州,2024/9/5,545,169,376
台风,徐州,2024/9/6,2012,253,1759
台风,徐州,2024/9/7,797,151,646
台风,徐州,2024/9/8,568,95,473
台风,徐州,2024/9/9,347,102,245
台风,徐州,2024/9/10,345,99,246
台风,徐州,2024/9/11,501,120,381
台风,徐州,2024/9/12,544,135,409
台风,徐州,2024/9/13,554,110,444
台风,徐州,2024/9/14,1053,190,863
台风,徐州,2024/9/15,1727,228,1499
台风,徐州,2024/9/16,2905,388,2517
台风,徐州,2024/9/17,2503,285,2218
台风,徐州,2024/9/18,1663,430,1233
台风,徐州,2024/9/19,1769,434,1335
台风,徐州,2024/9/20,1575,403,1172
台风,扬州,2024/8/21,203,93,110
台风,扬州,2024/8/22,204,99,105
台风,扬州,2024/8/23,154,80,74
台风,扬州,2024/8/24,164,78,86
台风,扬州,2024/8/25,158,78,80
台风,扬州,2024/8/26,155,76,79
台风,扬州,2024/8/27,221,85,136
台风,扬州,2024/8/28,227,102,125
台风,扬州,2024/8/29,193,91,102
台风,扬州,2024/8/30,177,80,97
台风,扬州,2024/8/31,159,70,89
台风,扬州,2024/9/1,166,74,92
台风,扬州,2024/9/2,237,99,138
台风,扬州,2024/9/3,247,104,143
台风,扬州,2024/9/4,338,123,215
台风,扬州,2024/9/5,561,226,335
台风,扬州,2024/9/6,1577,343,1234
台风,扬州,2024/9/7,690,159,531
台风,扬州,2024/9/8,400,85,315
台风,扬州,2024/9/9,340,151,189
台风,扬州,2024/9/10,439,173,266
台风,扬州,2024/9/11,670,215,455
台风,扬州,2024/9/12,626,201,425
台风,扬州,2024/9/13,752,219,533
台风,扬州,2024/9/14,1299,388,911
台风,扬州,2024/9/15,2733,515,2218
台风,扬州,2024/9/16,5614,859,4755
台风,扬州,2024/9/17,1630,267,1363
台风,扬州,2024/9/18,1599,620,979
台风,扬州,2024/9/19,2629,880,1749
台风,扬州,2024/9/20,2551,841,1710
台风,无锡,2024/8/21,454,151,303
台风,无锡,2024/8/22,308,125,183
台风,无锡,2024/8/23,281,99,182
台风,无锡,2024/8/24,246,78,168
台风,无锡,2024/8/25,212,64,148
台风,无锡,2024/8/26,326,137,189
台风,无锡,2024/8/27,416,135,281
台风,无锡,2024/8/28,426,151,275
台风,无锡,2024/8/29,421,159,262
台风,无锡,2024/8/30,326,131,195
台风,无锡,2024/8/31,278,82,196
台风,无锡,2024/9/1,300,83,217
台风,无锡,2024/9/2,546,173,373
台风,无锡,2024/9/3,591,194,397
台风,无锡,2024/9/4,662,207,455
台风,无锡,2024/9/5,1316,509,807
台风,无锡,2024/9/6,3541,852,2689
台风,无锡,2024/9/7,1327,366,961
台风,无锡,2024/9/8,1005,179,826
台风,无锡,2024/9/9,789,260,529
台风,无锡,2024/9/10,1177,321,856
台风,无锡,2024/9/11,2018,754,1264
台风,无锡,2024/9/12,1635,639,996
台风,无锡,2024/9/13,2126,843,1283
台风,无锡,2024/9/14,4438,1161,3277
台风,无锡,2024/9/15,12582,1292,11290
台风,无锡,2024/9/16,29255,3164,26091
台风,无锡,2024/9/17,6633,856,5777
台风,无锡,2024/9/18,8285,2168,6117
台风,无锡,2024/9/19,17962,4423,13539
台风,无锡,2024/9/20,11996,2245,9751
台风,杭州,2024/8/21,1985,820,1165
台风,杭州,2024/8/22,1297,450,847
台风,杭州,2024/8/23,969,278,691
台风,杭州,2024/8/24,720,148,572
台风,杭州,2024/8/25,822,166,656
台风,杭州,2024/8/26,1320,468,852
台风,杭州,2024/8/27,1674,648,1026
台风,杭州,2024/8/28,2027,810,1217
台风,杭州,2024/8/29,1610,689,921
台风,杭州,2024/8/30,1116,400,716
台风,杭州,2024/8/31,940,195,745
台风,杭州,2024/9/1,1192,250,942
台风,杭州,2024/9/2,2222,922,1300
台风,杭州,2024/9/3,2047,882,1165
台风,杭州,2024/9/4,2198,887,1311
台风,杭州,2024/9/5,4575,2088,2487
台风,杭州,2024/9/6,12705,3691,9014
台风,杭州,2024/9/7,4418,971,3447
台风,杭州,2024/9/8,2332,595,1737
台风,杭州,2024/9/9,2025,916,1109
台风,杭州,2024/9/10,6604,1966,4638
台风,杭州,2024/9/11,9096,3167,5929
台风,杭州,2024/9/12,11458,3957,7501
台风,杭州,2024/9/13,16757,5735,11022
台风,杭州,2024/9/14,35786,11451,24335
台风,杭州,2024/9/15,58332,7379,50953
台风,杭州,2024/9/16,51078,5922,45156
台风,杭州,2024/9/17,10834,1354,9480
台风,杭州,2024/9/18,24753,8210,16543
台风,杭州,2024/9/19,53566,17263,36303
台风,杭州,2024/9/20,16536,4750,11786
台风,池州,2024/8/21,119,59,60
台风,池州,2024/8/22,114,57,57
台风,池州,2024/8/23,60,0,60
台风,池州,2024/8/24,63,0,63
台风,池州,2024/8/25,66,0,66
台风,池州,2024/8/26,63,0,63
台风,池州,2024/8/27,126,57,69
台风,池州,2024/8/28,60,0,60
台风,池州,2024/8/29,57,0,57
台风,池州,2024/8/30,0,0,0
台风,池州,2024/8/31,58,0,58
台风,池州,2024/9/1,0,0,0
台风,池州,2024/9/2,132,59,73
台风,池州,2024/9/3,135,61,74
台风,池州,2024/9/4,139,57,82
台风,池州,2024/9/5,179,80,99
台风,池州,2024/9/6,271,76,195
台风,池州,2024/9/7,217,63,154
台风,池州,2024/9/8,147,61,86
台风,池州,2024/9/9,128,59,69
台风,池州,2024/9/10,154,57,97
台风,池州,2024/9/11,173,64,109
台风,池州,2024/9/12,147,61,86
台风,池州,2024/9/13,189,70,119
台风,池州,2024/9/14,236,66,170
台风,池州,2024/9/15,421,70,351
台风,池州,2024/9/16,720,114,606
台风,池州,2024/9/17,334,64,270
台风,池州,2024/9/18,287,83,204
台风,池州,2024/9/19,389,112,277
台风,池州,2024/9/20,244,70,174
台风,泰州,2024/8/21,199,68,131
台风,泰州,2024/8/22,150,59,91
台风,泰州,2024/8/23,158,66,92
台风,泰州,2024/8/24,152,63,89
台风,泰州,2024/8/25,87,0,87
台风,泰州,2024/8/26,166,64,102
台风,泰州,2024/8/27,169,61,108
台风,泰州,2024/8/28,195,78,117
台风,泰州,2024/8/29,173,78,95
台风,泰州,2024/8/30,152,61,91
台风,泰州,2024/8/31,154,57,97
台风,泰州,2024/9/1,164,64,100
台风,泰州,2024/9/2,232,97,135
台风,泰州,2024/9/3,226,95,131
台风,泰州,2024/9/4,257,95,162
台风,泰州,2024/9/5,406,165,241
台风,泰州,2024/9/6,1284,236,1048
台风,泰州,2024/9/7,616,148,468
台风,泰州,2024/9/8,359,82,277
台风,泰州,2024/9/9,273,89,184
台风,泰州,2024/9/10,363,120,243
台风,泰州,2024/9/11,599,170,429
台风,泰州,2024/9/12,459,142,317
台风,泰州,2024/9/13,574,162,412
台风,泰州,2024/9/14,1173,287,886
台风,泰州,2024/9/15,2616,395,2221
台风,泰州,2024/9/16,4957,611,4346
台风,泰州,2024/9/17,1233,157,1076
台风,泰州,2024/9/18,1355,391,964
台风,泰州,2024/9/19,2423,713,1710
台风,泰州,2024/9/20,2839,747,2092
台风,淮北,2024/8/21,57,0,57
台风,淮北,2024/8/22,120,59,61
台风,淮北,2024/8/23,118,57,61
台风,淮北,2024/8/24,57,0,57
台风,淮北,2024/8/25,123,57,66
台风,淮北,2024/8/26,118,57,61
台风,淮北,2024/8/27,126,57,69
台风,淮北,2024/8/28,67,0,67
台风,淮北,2024/8/29,117,57,60
台风,淮北,2024/8/30,117,57,60
台风,淮北,2024/8/31,114,57,57
台风,淮北,2024/9/1,60,0,60
台风,淮北,2024/9/2,120,59,61
台风,淮北,2024/9/3,120,57,63
台风,淮北,2024/9/4,123,57,66
台风,淮北,2024/9/5,157,66,91
台风,淮北,2024/9/6,307,78,229
台风,淮北,2024/9/7,227,68,159
台风,淮北,2024/9/8,180,57,123
台风,淮北,2024/9/9,148,57,91
台风,淮北,2024/9/10,141,57,84
台风,淮北,2024/9/11,145,59,86
台风,淮北,2024/9/12,110,0,110
台风,淮北,2024/9/13,159,59,100
台风,淮北,2024/9/14,206,68,138
台风,淮北,2024/9/15,336,72,264
台风,淮北,2024/9/16,618,74,544
台风,淮北,2024/9/17,810,83,727
台风,淮北,2024/9/18,665,125,540
台风,淮北,2024/9/19,427,104,323
台风,淮北,2024/9/20,382,97,285
台风,淮南,2024/8/21,124,66,58
台风,淮南,2024/8/22,127,66,61
台风,淮南,2024/8/23,122,61,61
台风,淮南,2024/8/24,132,63,69
台风,淮南,2024/8/25,125,64,61
台风,淮南,2024/8/26,124,61,63
台风,淮南,2024/8/27,130,63,67
台风,淮南,2024/8/28,127,66,61
台风,淮南,2024/8/29,124,63,61
台风,淮南,2024/8/30,128,68,60
台风,淮南,2024/8/31,64,64,0
台风,淮南,2024/9/1,64,64,0
台风,淮南,2024/9/2,136,76,60
台风,淮南,2024/9/3,144,78,66
台风,淮南,2024/9/4,175,82,93
台风,淮南,2024/9/5,192,87,105
台风,淮南,2024/9/6,383,121,262
台风,淮南,2024/9/7,282,93,189
台风,淮南,2024/9/8,202,76,126
台风,淮南,2024/9/9,165,70,95
台风,淮南,2024/9/10,169,72,97
台风,淮南,2024/9/11,188,70,118
台风,淮南,2024/9/12,189,76,113
台风,淮南,2024/9/13,184,76,108
台风,淮南,2024/9/14,250,85,165
台风,淮南,2024/9/15,559,137,422
台风,淮南,2024/9/16,1086,183,903
台风,淮南,2024/9/17,1077,157,920
台风,淮南,2024/9/18,455,121,334
台风,淮南,2024/9/19,510,140,370
台风,淮南,2024/9/20,342,89,253
台风,淮安,2024/8/21,182,57,125
台风,淮安,2024/8/22,163,57,106
台风,淮安,2024/8/23,143,57,86
台风,淮安,2024/8/24,146,57,89
台风,淮安,2024/8/25,163,59,104
台风,淮安,2024/8/26,104,0,104
台风,淮安,2024/8/27,171,63,108
台风,淮安,2024/8/28,184,61,123
台风,淮安,2024/8/29,140,57,83
台风,淮安,2024/8/30,141,59,82
台风,淮安,2024/8/31,152,57,95
台风,淮安,2024/9/1,166,57,109
台风,淮安,2024/9/2,180,57,123
台风,淮安,2024/9/3,208,61,147
台风,淮安,2024/9/4,287,78,209
台风,淮安,2024/9/5,382,123,259
台风,淮安,2024/9/6,1162,182,980
台风,淮安,2024/9/7,441,104,337
台风,淮安,2024/9/8,373,70,303
台风,淮安,2024/9/9,240,70,170
台风,淮安,2024/9/10,255,78,177
台风,淮安,2024/9/11,410,91,319
台风,淮安,2024/9/12,406,87,319
台风,淮安,2024/9/13,474,125,349
台风,淮安,2024/9/14,816,173,643
台风,淮安,2024/9/15,1192,198,994
台风,淮安,2024/9/16,2128,357,1771
台风,淮安,2024/9/17,1056,152,904
台风,淮安,2024/9/18,996,223,773
台风,淮安,2024/9/19,1210,305,905
台风,淮安,2024/9/20,1174,271,903
台风,温州,2024/8/21,4346,886,3460
台风,温州,2024/8/22,1622,450,1172
台风,温州,2024/8/23,1572,367,1205
台风,温州,2024/8/24,1068,193,875
台风,温州,2024/8/25,1051,175,876
台风,温州,2024/8/26,1174,302,872
台风,温州,2024/8/27,2062,436,1626
台风,温州,2024/8/28,3365,870,2495
台风,温州,2024/8/29,1515,439,1076
台风,温州,2024/8/30,1185,281,904
台风,温州,2024/8/31,1215,257,958
台风,温州,2024/9/1,2082,346,1736
台风,温州,2024/9/2,2703,792,1911
台风,温州,2024/9/3,2437,779,1658
台风,温州,2024/9/4,2374,678,1696
台风,温州,2024/9/5,3858,1080,2778
台风,温州,2024/9/6,11408,2275,9133
台风,温州,2024/9/7,4621,939,3682
台风,温州,2024/9/8,2429,488,1941
台风,温州,2024/9/9,1690,586,1104
台风,温州,2024/9/10,5310,964,4346
台风,温州,2024/9/11,8010,1747,6263
台风,温州,2024/9/12,12021,2481,9540
台风,温州,2024/9/13,14609,3132,11477
台风,温州,2024/9/14,21119,4254,16865
台风,温州,2024/9/15,20989,2621,18368
台风,温州,2024/9/16,16697,1835,14862
台风,温州,2024/9/17,8976,883,8093
台风,温州,2024/9/18,20250,4445,15805
台风,温州,2024/9/19,24827,5443,19384
台风,温州,2024/9/20,5642,1200,4442
台风,湖州,2024/8/21,517,148,369
台风,湖州,2024/8/22,281,89,192
台风,湖州,2024/8/23,296,72,224
台风,湖州,2024/8/24,252,72,180
台风,湖州,2024/8/25,247,61,186
台风,湖州,2024/8/26,287,83,204
台风,湖州,2024/8/27,479,114,365
台风,湖州,2024/8/28,500,131,369
台风,湖州,2024/8/29,359,139,220
台风,湖州,2024/8/30,268,85,183
台风,湖州,2024/8/31,325,110,215
台风,湖州,2024/9/1,389,89,300
台风,湖州,2024/9/2,499,144,355
台风,湖州,2024/9/3,512,140,372
台风,湖州,2024/9/4,448,110,338
台风,湖州,2024/9/5,886,290,596
台风,湖州,2024/9/6,1830,465,1365
台风,湖州,2024/9/7,1110,250,860
台风,湖州,2024/9/8,680,121,559
台风,湖州,2024/9/9,500,162,338
台风,湖州,2024/9/10,1182,284,898
台风,湖州,2024/9/11,1423,459,964
台风,湖州,2024/9/12,1447,451,996
台风,湖州,2024/9/13,2105,678,1427
台风,湖州,2024/9/14,4364,981,3383
台风,湖州,2024/9/15,9206,999,8207
台风,湖州,2024/9/16,11100,1080,10020
台风,湖州,2024/9/17,2171,282,1889
台风,湖州,2024/9/18,3497,932,2565
台风,湖州,2024/9/19,6402,1453,4949
台风,湖州,2024/9/20,2672,690,1982
台风,滁州,2024/8/21,74,0,74
台风,滁州,2024/8/22,60,0,60
台风,滁州,2024/8/23,74,0,74
台风,滁州,2024/8/24,61,0,61
台风,滁州,2024/8/25,60,0,60
台风,滁州,2024/8/26,124,57,67
台风,滁州,2024/8/27,147,63,84
台风,滁州,2024/8/28,137,61,76
台风,滁州,2024/8/29,126,59,67
台风,滁州,2024/8/30,125,59,66
台风,滁州,2024/8/31,117,57,60
台风,滁州,2024/9/1,124,57,67
台风,滁州,2024/9/2,147,63,84
台风,滁州,2024/9/3,84,0,84
台风,滁州,2024/9/4,159,63,96
台风,滁州,2024/9/5,241,102,139
台风,滁州,2024/9/6,537,123,414
台风,滁州,2024/9/7,316,74,242
台风,滁州,2024/9/8,240,66,174
台风,滁州,2024/9/9,161,66,95
台风,滁州,2024/9/10,190,68,122
台风,滁州,2024/9/11,297,89,208
台风,滁州,2024/9/12,276,99,177
台风,滁州,2024/9/13,295,99,196
台风,滁州,2024/9/14,466,121,345
台风,滁州,2024/9/15,1037,158,879
台风,滁州,2024/9/16,2036,363,1673
台风,滁州,2024/9/17,1173,146,1027
台风,滁州,2024/9/18,868,191,677
台风,滁州,2024/9/19,1083,208,875
台风,滁州,2024/9/20,878,176,702
台风,盐城,2024/8/21,242,80,162
台风,盐城,2024/8/22,176,66,110
台风,盐城,2024/8/23,189,61,128
台风,盐城,2024/8/24,156,59,97
台风,盐城,2024/8/25,174,57,117
台风,盐城,2024/8/26,192,66,126
台风,盐城,2024/8/27,229,78,151
台风,盐城,2024/8/28,252,74,178
台风,盐城,2024/8/29,201,80,121
台风,盐城,2024/8/30,163,61,102
台风,盐城,2024/8/31,155,64,91
台风,盐城,2024/9/1,167,61,106
台风,盐城,2024/9/2,259,76,183
台风,盐城,2024/9/3,243,85,158
台风,盐城,2024/9/4,270,87,183
台风,盐城,2024/9/5,529,177,352
台风,盐城,2024/9/6,1756,273,1483
台风,盐城,2024/9/7,800,155,645
台风,盐城,2024/9/8,463,91,372
台风,盐城,2024/9/9,344,97,247
台风,盐城,2024/9/10,459,110,349
台风,盐城,2024/9/11,1134,260,874
台风,盐城,2024/9/12,1065,222,843
台风,盐城,2024/9/13,946,209,737
台风,盐城,2024/9/14,1503,403,1100
台风,盐城,2024/9/15,3112,467,2645
台风,盐城,2024/9/16,4792,644,4148
台风,盐城,2024/9/17,1402,177,1225
台风,盐城,2024/9/18,1465,440,1025
台风,盐城,2024/9/19,2679,678,2001
台风,盐城,2024/9/20,3440,883,2557
台风,绍兴,2024/8/21,807,159,648
台风,绍兴,2024/8/22,511,142,369
台风,绍兴,2024/8/23,452,118,334
台风,绍兴,2024/8/24,345,76,269
台风,绍兴,2024/8/25,383,82,301
台风,绍兴,2024/8/26,496,163,333
台风,绍兴,2024/8/27,898,211,687
台风,绍兴,2024/8/28,925,202,723
台风,绍兴,2024/8/29,670,202,468
台风,绍兴,2024/8/30,383,127,256
台风,绍兴,2024/8/31,425,108,317
台风,绍兴,2024/9/1,656,104,552
台风,绍兴,2024/9/2,1007,237,770
台风,绍兴,2024/9/3,922,231,691
台风,绍兴,2024/9/4,937,182,755
台风,绍兴,2024/9/5,1358,456,902
台风,绍兴,2024/9/6,3216,849,2367
台风,绍兴,2024/9/7,1343,323,1020
台风,绍兴,2024/9/8,1007,152,855
台风,绍兴,2024/9/9,821,225,596
台风,绍兴,2024/9/10,1844,484,1360
台风,绍兴,2024/9/11,2535,810,1725
台风,绍兴,2024/9/12,2980,887,2093
台风,绍兴,2024/9/13,4065,976,3089
台风,绍兴,2024/9/14,7755,1625,6130
台风,绍兴,2024/9/15,14189,1415,12774
台风,绍兴,2024/9/16,11276,944,10332
台风,绍兴,2024/9/17,3040,408,2632
台风,绍兴,2024/9/18,6363,1393,4970
台风,绍兴,2024/9/19,14206,2787,11419
台风,绍兴,2024/9/20,3503,878,2625
台风,舟山,2024/8/21,1194,253,941
台风,舟山,2024/8/22,738,159,579
台风,舟山,2024/8/23,508,120,388
台风,舟山,2024/8/24,394,80,314
台风,舟山,2024/8/25,471,76,395
台风,舟山,2024/8/26,767,182,585
台风,舟山,2024/8/27,1105,234,871
台风,舟山,2024/8/28,997,195,802
台风,舟山,2024/8/29,683,144,539
台风,舟山,2024/8/30,504,116,388
台风,舟山,2024/8/31,528,91,437
台风,舟山,2024/9/1,925,102,823
台风,舟山,2024/9/2,1098,234,864
台风,舟山,2024/9/3,978,184,794
台风,舟山,2024/9/4,889,166,723
台风,舟山,2024/9/5,1131,254,877
台风,舟山,2024/9/6,1587,422,1165
台风,舟山,2024/9/7,1036,173,863
台风,舟山,2024/9/8,826,127,699
台风,舟山,2024/9/9,852,202,650
台风,舟山,2024/9/10,2133,506,1627
台风,舟山,2024/9/11,3222,861,2361
台风,舟山,2024/9/12,3774,908,2866
台风,舟山,2024/9/13,5322,997,4325
台风,舟山,2024/9/14,7691,1227,6464
台风,舟山,2024/9/15,13372,1345,12027
台风,舟山,2024/9/16,8224,851,7373
台风,舟山,2024/9/17,2846,399,2447
台风,舟山,2024/9/18,4793,947,3846
台风,舟山,2024/9/19,9297,1590,7707
台风,舟山,2024/9/20,2188,504,1684
台风,芜湖,2024/8/21,142,63,79
台风,芜湖,2024/8/22,147,64,83
台风,芜湖,2024/8/23,133,59,74
台风,芜湖,2024/8/24,137,59,78
台风,芜湖,2024/8/25,74,0,74
台风,芜湖,2024/8/26,146,59,87
台风,芜湖,2024/8/27,173,63,110
台风,芜湖,2024/8/28,155,63,92
台风,芜湖,2024/8/29,140,57,83
台风,芜湖,2024/8/30,143,63,80
台风,芜湖,2024/8/31,143,64,79
台风,芜湖,2024/9/1,160,63,97
台风,芜湖,2024/9/2,203,68,135
台风,芜湖,2024/9/3,187,66,121
台风,芜湖,2024/9/4,223,68,155
台风,芜湖,2024/9/5,374,146,228
台风,芜湖,2024/9/6,741,187,554
台风,芜湖,2024/9/7,519,133,386
台风,芜湖,2024/9/8,334,74,260
台风,芜湖,2024/9/9,246,78,168
台风,芜湖,2024/9/10,297,93,204
台风,芜湖,2024/9/11,400,139,261
台风,芜湖,2024/9/12,381,121,260
台风,芜湖,2024/9/13,389,144,245
台风,芜湖,2024/9/14,835,208,627
台风,芜湖,2024/9/15,1233,202,1031
台风,芜湖,2024/9/16,2391,426,1965
台风,芜湖,2024/9/17,1101,169,932
台风,芜湖,2024/9/18,1004,259,745
台风,芜湖,2024/9/19,1268,366,902
台风,芜湖,2024/9/20,1040,274,766
台风,苏州,2024/8/21,1294,439,855
台风,苏州,2024/8/22,622,220,402
台风,苏州,2024/8/23,559,183,376
台风,苏州,2024/8/24,427,99,328
台风,苏州,2024/8/25,466,104,362
台风,苏州,2024/8/26,767,250,517
台风,苏州,2024/8/27,1090,349,741
台风,苏州,2024/8/28,973,293,680
台风,苏州,2024/8/29,897,330,567
台风,苏州,2024/8/30,600,213,387
台风,苏州,2024/8/31,442,121,321
台风,苏州,2024/9/1,523,112,411
台风,苏州,2024/9/2,1421,554,867
台风,苏州,2024/9/3,1244,403,841
台风,苏州,2024/9/4,1308,425,883
台风,苏州,2024/9/5,2287,946,1341
台风,苏州,2024/9/6,8052,1553,6499
台风,苏州,2024/9/7,2909,757,2152
台风,苏州,2024/9/8,1542,333,1209
台风,苏州,2024/9/9,1576,650,926
台风,苏州,2024/9/10,2417,846,1571
台风,苏州,2024/9/11,4742,1438,3304
台风,苏州,2024/9/12,3819,1065,2754
台风,苏州,2024/9/13,5549,1740,3809
台风,苏州,2024/9/14,14811,4019,10792
台风,苏州,2024/9/15,42418,4603,37815
台风,苏州,2024/9/16,66814,6831,59983
台风,苏州,2024/9/17,11745,1016,10729
台风,苏州,2024/9/18,19451,5638,13813
台风,苏州,2024/9/19,38849,9908,28941
台风,苏州,2024/9/20,20800,4051,16749
台风,蚌埠,2024/8/21,74,0,74
台风,蚌埠,2024/8/22,127,57,70
台风,蚌埠,2024/8/23,122,57,65
台风,蚌埠,2024/8/24,63,0,63
台风,蚌埠,2024/8/25,67,0,67
台风,蚌埠,2024/8/26,139,63,76
台风,蚌埠,2024/8/27,131,57,74
台风,蚌埠,2024/8/28,133,63,70
台风,蚌埠,2024/8/29,124,59,65
台风,蚌埠,2024/8/30,57,0,57
台风,蚌埠,2024/8/31,66,0,66
台风,蚌埠,2024/9/1,73,0,73
台风,蚌埠,2024/9/2,129,59,70
台风,蚌埠,2024/9/3,142,59,83
台风,蚌埠,2024/9/4,176,66,110
台风,蚌埠,2024/9/5,256,89,167
台风,蚌埠,2024/9/6,490,137,353
台风,蚌埠,2024/9/7,340,87,253
台风,蚌埠,2024/9/8,246,64,182
台风,蚌埠,2024/9/9,187,72,115
台风,蚌埠,2024/9/10,165,57,108
台风,蚌埠,2024/9/11,215,66,149
台风,蚌埠,2024/9/12,225,63,162
台风,蚌埠,2024/9/13,229,85,144
台风,蚌埠,2024/9/14,346,97,249
台风,蚌埠,2024/9/15,820,139,681
台风,蚌埠,2024/9/16,1138,157,981
台风,蚌埠,2024/9/17,1090,127,963
台风,蚌埠,2024/9/18,698,158,540
台风,蚌埠,2024/9/19,719,159,560
台风,蚌埠,2024/9/20,558,150,408
台风,衢州,2024/8/21,259,76,183
台风,衢州,2024/8/22,200,72,128
台风,衢州,2024/8/23,187,74,113
台风,衢州,2024/8/24,92,0,92
台风,衢州,2024/8/25,167,59,108
台风,衢州,2024/8/26,185,64,121
台风,衢州,2024/8/27,242,74,168
台风,衢州,2024/8/28,273,93,180
台风,衢州,2024/8/29,223,76,147
台风,衢州,2024/8/30,170,66,104
台风,衢州,2024/8/31,174,57,117
台风,衢州,2024/9/1,211,63,148
台风,衢州,2024/9/2,272,89,183
台风,衢州,2024/9/3,272,85,187
台风,衢州,2024/9/4,271,78,193
台风,衢州,2024/9/5,435,140,295
台风,衢州,2024/9/6,1086,197,889
台风,衢州,2024/9/7,514,106,408
台风,衢州,2024/9/8,314,89,225
台风,衢州,2024/9/9,250,91,159
台风,衢州,2024/9/10,525,118,407
台风,衢州,2024/9/11,717,150,567
台风,衢州,2024/9/12,891,202,689
台风,衢州,2024/9/13,1114,267,847
台风,衢州,2024/9/14,1350,395,955
台风,衢州,2024/9/15,2008,309,1699
台风,衢州,2024/9/16,1691,215,1476
台风,衢州,2024/9/17,956,116,840
台风,衢州,2024/9/18,1214,324,890
台风,衢州,2024/9/19,1664,507,1157
台风,衢州,2024/9/20,786,176,610
台风,连云港,2024/8/21,183,61,122
台风,连云港,2024/8/22,171,63,108
台风,连云港,2024/8/23,156,57,99
台风,连云港,2024/8/24,163,57,106
台风,连云港,2024/8/25,96,0,96
台风,连云港,2024/8/26,186,64,122
台风,连云港,2024/8/27,294,76,218
台风,连云港,2024/8/28,220,66,154
台风,连云港,2024/8/29,187,57,130
台风,连云港,2024/8/30,151,59,92
台风,连云港,2024/8/31,144,57,87
台风,连云港,2024/9/1,167,57,110
台风,连云港,2024/9/2,202,68,134
台风,连云港,2024/9/3,189,66,123
台风,连云港,2024/9/4,233,74,159
台风,连云港,2024/9/5,473,150,323
台风,连云港,2024/9/6,1317,197,1120
台风,连云港,2024/9/7,530,101,429
台风,连云港,2024/9/8,398,95,303
台风,连云港,2024/9/9,282,89,193
台风,连云港,2024/9/10,326,72,254
台风,连云港,2024/9/11,578,148,430
台风,连云港,2024/9/12,565,150,415
台风,连云港,2024/9/13,722,180,542
台风,连云港,2024/9/14,1051,216,835
台风,连云港,2024/9/15,1438,233,1205
台风,连云港,2024/9/16,2038,279,1759
台风,连云港,2024/9/17,1094,135,959
台风,连云港,2024/9/18,1066,250,816
台风,连云港,2024/9/19,1235,321,914
台风,连云港,2024/9/20,1174,242,932
台风,金华,2024/8/21,801,183,618
台风,金华,2024/8/22,483,148,335
台风,金华,2024/8/23,358,91,267
台风,金华,2024/8/24,296,72,224
台风,金华,2024/8/25,327,64,263
台风,金华,2024/8/26,373,120,253
台风,金华,2024/8/27,802,175,627
台风,金华,2024/8/28,691,188,503
台风,金华,2024/8/29,446,155,291
台风,金华,2024/8/30,348,120,228
台风,金华,2024/8/31,394,95,299
台风,金华,2024/9/1,491,80,411
台风,金华,2024/9/2,747,207,540
台风,金华,2024/9/3,727,202,525
台风,金华,2024/9/4,818,240,578
台风,金华,2024/9/5,1455,575,880
台风,金华,2024/9/6,3459,886,2573
台风,金华,2024/9/7,1501,504,997
台风,金华,2024/9/8,1042,195,847
台风,金华,2024/9/9,782,270,512
台风,金华,2024/9/10,1491,493,998
台风,金华,2024/9/11,1952,706,1246
台风,金华,2024/9/12,2414,848,1566
台风,金华,2024/9/13,3038,894,2144
台风,金华,2024/9/14,4663,1069,3594
台风,金华,2024/9/15,7085,994,6091
台风,金华,2024/9/16,6161,920,5241
台风,金华,2024/9/17,2238,408,1830
台风,金华,2024/9/18,4209,1044,3165
台风,金华,2024/9/19,7084,1815,5269
台风,金华,2024/9/20,2529,861,1668
台风,铜陵,2024/8/21,115,57,58
台风,铜陵,2024/8/22,57,0,57
台风,铜陵,2024/8/23,58,0,58
台风,铜陵,2024/8/24,123,57,66
台风,铜陵,2024/8/25,61,0,61
台风,铜陵,2024/8/26,58,0,58
台风,铜陵,2024/8/27,120,57,63
台风,铜陵,2024/8/28,63,0,63
台风,铜陵,2024/8/29,117,57,60
台风,铜陵,2024/8/30,63,0,63
台风,铜陵,2024/8/31,63,0,63
台风,铜陵,2024/9/1,66,0,66
台风,铜陵,2024/9/2,127,57,70
台风,铜陵,2024/9/3,124,59,65
台风,铜陵,2024/9/4,140,61,79
台风,铜陵,2024/9/5,160,64,96
台风,铜陵,2024/9/6,252,87,165
台风,铜陵,2024/9/7,215,64,151
台风,铜陵,2024/9/8,158,63,95
台风,铜陵,2024/9/9,147,61,86
台风,铜陵,2024/9/10,141,59,82
台风,铜陵,2024/9/11,163,64,99
台风,铜陵,2024/9/12,147,61,86
台风,铜陵,2024/9/13,161,66,95
台风,铜陵,2024/9/14,251,93,158
台风,铜陵,2024/9/15,465,89,376
台风,铜陵,2024/9/16,834,131,703
台风,铜陵,2024/9/17,377,78,299
台风,铜陵,2024/9/18,311,89,222
台风,铜陵,2024/9/19,386,131,255
台风,铜陵,2024/9/20,267,78,189
台风,镇江,2024/8/21,187,59,128
台风,镇江,2024/8/22,136,63,73
台风,镇江,2024/8/23,71,0,71
台风,镇江,2024/8/24,145,59,86
台风,镇江,2024/8/25,137,57,80
台风,镇江,2024/8/26,146,63,83
台风,镇江,2024/8/27,176,66,110
台风,镇江,2024/8/28,161,68,93
台风,镇江,2024/8/29,155,68,87
台风,镇江,2024/8/30,129,59,70
台风,镇江,2024/8/31,144,64,80
台风,镇江,2024/9/1,183,57,126
台风,镇江,2024/9/2,199,78,121
台风,镇江,2024/9/3,193,72,121
台风,镇江,2024/9/4,237,78,159
台风,镇江,2024/9/5,415,154,261
台风,镇江,2024/9/6,1201,231,970
台风,镇江,2024/9/7,615,140,475
台风,镇江,2024/9/8,339,80,259
台风,镇江,2024/9/9,280,99,181
台风,镇江,2024/9/10,383,99,284
台风,镇江,2024/9/11,663,172,491
台风,镇江,2024/9/12,577,163,414
台风,镇江,2024/9/13,694,186,508
台风,镇江,2024/9/14,1337,371,966
台风,镇江,2024/9/15,2999,544,2455
台风,镇江,2024/9/16,6933,916,6017
台风,镇江,2024/9/17,1849,262,1587
台风,镇江,2024/9/18,1681,535,1146
台风,镇江,2024/9/19,3025,860,2165
台风,镇江,2024/9/20,2835,827,2008
台风,阜阳,2024/8/21,66,0,66
台风,阜阳,2024/8/22,137,57,80
台风,阜阳,2024/8/23,135,59,76
台风,阜阳,2024/8/24,71,0,71
台风,阜阳,2024/8/25,127,57,70
台风,阜阳,2024/8/26,89,0,89
台风,阜阳,2024/8/27,131,57,74
台风,阜阳,2024/8/28,137,57,80
台风,阜阳,2024/8/29,143,64,79
台风,阜阳,2024/8/30,128,59,69
台风,阜阳,2024/8/31,67,0,67
台风,阜阳,2024/9/1,74,0,74
台风,阜阳,2024/9/2,143,59,84
台风,阜阳,2024/9/3,151,59,92
台风,阜阳,2024/9/4,206,59,147
台风,阜阳,2024/9/5,293,87,206
台风,阜阳,2024/9/6,551,131,420
台风,阜阳,2024/9/7,368,72,296
台风,阜阳,2024/9/8,294,66,228
台风,阜阳,2024/9/9,204,68,136
台风,阜阳,2024/9/10,145,0,145
台风,阜阳,2024/9/11,221,63,158
台风,阜阳,2024/9/12,255,78,177
台风,阜阳,2024/9/13,216,61,155
台风,阜阳,2024/9/14,292,78,214
台风,阜阳,2024/9/15,703,89,614
台风,阜阳,2024/9/16,1114,159,955
台风,阜阳,2024/9/17,1453,139,1314
台风,阜阳,2024/9/18,715,116,599
台风,阜阳,2024/9/19,546,121,425
台风,阜阳,2024/9/20,469,93,376
台风,马鞍山,2024/8/21,148,61,87
台风,马鞍山,2024/8/22,132,63,69
台风,马鞍山,2024/8/23,123,57,66
台风,马鞍山,2024/8/24,78,0,78
台风,马鞍山,2024/8/25,67,0,67
台风,马鞍山,2024/8/26,130,61,69
台风,马鞍山,2024/8/27,137,61,76
台风,马鞍山,2024/8/28,137,57,80
台风,马鞍山,2024/8/29,124,59,65
台风,马鞍山,2024/8/30,69,0,69
台风,马鞍山,2024/8/31,128,57,71
台风,马鞍山,2024/9/1,141,61,80
台风,马鞍山,2024/9/2,139,61,78
台风,马鞍山,2024/9/3,151,68,83
台风,马鞍山,2024/9/4,203,101,102
台风,马鞍山,2024/9/5,262,121,141
台风,马鞍山,2024/9/6,485,157,328
台风,马鞍山,2024/9/7,318,106,212
台风,马鞍山,2024/9/8,225,74,151
台风,马鞍山,2024/9/9,203,95,108
台风,马鞍山,2024/9/10,202,72,130
台风,马鞍山,2024/9/11,290,85,205
台风,马鞍山,2024/9/12,257,97,160
台风,马鞍山,2024/9/13,313,110,203
台风,马鞍山,2024/9/14,548,142,406
台风,马鞍山,2024/9/15,1095,193,902
台风,马鞍山,2024/9/16,2178,361,1817
台风,马鞍山,2024/9/17,1084,179,905
台风,马鞍山,2024/9/18,796,190,606
台风,马鞍山,2024/9/19,1105,268,837
台风,马鞍山,2024/9/20,870,229,641
台风,黄山,2024/8/21,147,61,86
台风,黄山,2024/8/22,117,57,60
台风,黄山,2024/8/23,114,57,57
台风,黄山,2024/8/24,61,0,61
台风,黄山,2024/8/25,63,0,63
台风,黄山,2024/8/26,0,0,0
台风,黄山,2024/8/27,71,0,71
台风,黄山,2024/8/28,63,0,63
台风,黄山,2024/8/29,117,59,58
台风,黄山,2024/8/30,118,57,61
台风,黄山,2024/8/31,0,0,0
台风,黄山,2024/9/1,58,0,58
台风,黄山,2024/9/2,73,0,73
台风,黄山,2024/9/3,132,59,73
台风,黄山,2024/9/4,143,59,84
台风,黄山,2024/9/5,217,85,132
台风,黄山,2024/9/6,298,97,201
台风,黄山,2024/9/7,219,64,155
台风,黄山,2024/9/8,175,66,109
台风,黄山,2024/9/9,150,63,87
台风,黄山,2024/9/10,174,74,100
台风,黄山,2024/9/11,170,64,106
台风,黄山,2024/9/12,176,61,115
台风,黄山,2024/9/13,221,76,145
台风,黄山,2024/9/14,305,80,225
台风,黄山,2024/9/15,682,80,602
台风,黄山,2024/9/16,955,108,847
台风,黄山,2024/9/17,409,63,346
台风,黄山,2024/9/18,331,99,232
台风,黄山,2024/9/19,453,125,328
台风,黄山,2024/9/20,299,91,208
